111111111111111111111111111111111111111111111111111111111
100000000000000000000000000000000000000000000000000000001
1000CC00CCC0000CCC00CCC00CCC000C00CCC0C000CC00CCC00CCC001
100C0C00C0C0000C00C0C00C0C00C0C0C0C000C00C00C0C00C0C00C01
10C00C0000C0000CCC00C00C0C00C0C000CCC0C00C00C0C00C0C00C01
10CCCCC00C00000C00C0CCCC0CCC00C0C0C000C00C00C0C00C0CCCC01
10000C00C000000C00C0C00C0C0CC00C00CCC0CC00CC00C00C0C00C01
10000C00CCC0000CCCC00000000000000000000000000000000000001
100000000000000000000000000000000000000000000000000000001
100000000000011100111000100100000100111100100000000000001
100000000000010010100101010100001100100101100000000000001
100000P0000001001010010100011110010000100010000000E000001
100000000000010010111101010100100100000100100000000000001
100000000000010010100100100100100100100100100000000000001
100000000000000000000000000000001110111101110000000000001
100000000000000000000000000000000000000000000000000000001
111111111111111111111111111111111111111111111111111111111