111111111111111111111111111111111111111111111111111111111
100C00000000000000000000000000000000000C0000C000000000001
100111001110000111001110011100010011101000110011100111001
100101001010000100101001010010101010001001001010010100101
101001000010000111001001010010100011101001001010010100101
101111100100000100101111011100101010001001001010010111101
100001001000000100101001010110010011101100110010010100101
1000010011100001111000000000000000000000000000000C0000001
1000000000000000000000000000000000000000000000000C00C0001
100000000000011100111000100100000100111100100000000000001
1000C0000000010010100101010100001100100101100000000000001
1000C0000000010010100101P001111001000010001000000000C0001
1000000C0000010010111101010100100100000100100000000000001
10000000000001001010010010010010010010E100100000000000001
10000000C000000000000000000000001110111101110000000000001
100C00000000000000000000000000000000000000000000000000001
111111111111111111111111111111111111111111111111111111111