111111111
100000001
1001000C1
101110001
1P010E001
111111111