11111111
10000001
100100C1
10110001
1P010E01
11111111