11111111111111111111111111111111111111111
10000000P1C00000000000000000000000000CCC1
10111111110111111111111111111101111111001
1000000000000000000000000000010000CCCCC01
11111111111111111111111111110100000000001
10000000000000000000000000000101111111111
10111111111111111111011111111E0000000CCC1
10000000000000100000000100000000000000001
10000000000000101111111111111CC1111111111
100000000CCCCC1000000000000000000000CC001
11111111111111111111111111111111111111111
