1111111
10000C1
1P0E001
1111111