1111111111111111111111111111111111
1000000000000000000000000000000001
1011111001100100000110011100111101
1010001010010100001001010010100001
1011100010010100001001010010101001
1000011010010100001001010010100101
1010001001100100100110010010111101
1011111000000111100000000000000001
10000000000000000000000000CEP00001
1111111111111111111111111111111111
