11111111111111111111111111111111111
10000000000000000000000000000000001
10111001110001001000001001111001001
10100101001010101000011001001011001
10100101001010001111001000010001001
10100101111010101001001000001001001
10100101001001001001001001001001001
10000000000000000000011101111011101
100CEP00000000000000000000000000001
11111111111111111111111111111111111