1111111
10C0001
1P01EC1
1111111