11111111111111111111111
1000000000C111101001101
1111010010C100111110011
10010011011011101001111
11111011011000111101111
11101100101111000110111
10111001011000111001111
100111000011011010011C1
111011010110110010111E1
11100011100111001001101
111101101101001111100P1
11111111111111111111111
