11111111111
100010001C1
10100101001
1E110001011
11000100001
11P00C00101
10011000001
10C11001101
11000100CC1
11111111111