1111111111
10010000E1
1010011111
1011011011
1100001001
1000111001
1110110001
1000001001
1011010C11
1P00000011
1111111111