11111111111111111111111
100000000001111010010E1
1101010010C100001100011
10010010010010101001001
1011101101100010110C1C1
101000001011C1000110111
101C10C1011000110000111
10011100001001100001111
11P01101011C11001011111
10C0001C00010C0C1001111
11101101101C011111C0011
11111111111111111111111
