1111111111111111111111111
100000000000C0000000000P1
1011111111111111111111111
101000000000C000000000001
1010111111111111111111101
101010000000C000000000101
1010101111111111111110101
101010100000C000000010101
1010101011111111111010101
101010101000C000001C1C1C1
1010101010111111101010101
10101010101C000C101010101
101010101011E010101010101
1010101010100C10101010101
1010101010111110101010101
101010101000000C101010101
1C1C1C1C11111111101010101
1010101000000000001010101
1010101111111111111010101
1010100000000000000010101
1010111111111111111110101
1010000000000000000000101
1011111111111111111111101
1000000000000000000000001
1111111111111111111111111