111111
1000E1
1011C1
101101
1P0001
111111