11111111111111111111111111111111
1000000000000000000000C00000C001
10100101001000001010010000101001
10100100101010100010010000101001
100000000000000000C00000000C0001
10100100101010100010010000101001
100000000000000C00000C0000000001
100000000000000C00000C0000000001
10100100101010100010010000101001
10100100101010100010010000101001
100000000C0000000C00000000000001
10000C000000000C0000000000000001
100000000C00000000000C0000000001
10100100101010100010000010101001
11001001001000110010010001000001
100000000C00000C0000000000000001
10000000000C00000C00000000000001
1000000000C000000000C00000000001
1E0000000000000C00000C0000000001
10010010010101010010010000100101
10010100101010100010010000101001
1P0000000C00C00000000000000000C1
11111111111111111111111111111111