11111111111111111111111111111111
100000000000000C00000C0000000001
10100101001000001010010000101001
10100100101010100010010000101001
100000000000000C00000C0000000001
10100100101010100010010000101001
100000000000000C00000C0000000001
100000000000000C00000C0000000001
10100100101010100010010000101001
10100100101010100010010000101001
100000000000000C00000C0000000001
100000000000000C00000C0000000001
100000000000000C00000C0000000001
10100100101010100010010000101001
10100100101010100010010000101001
100000000000000C00000C0000000001
100000000000000C00000C0000000001
100000000000000C00000C0000000001
1E0000000000000C00000C0000000001
10100100101010100010010000101001
10100100101010100010010000101001
1P0000000C00C00000000000000000C1
11111111111111111111111111111111