AAAAAAAAAAAAAAAAAAAA
10000000000000000001
100000001000000000C1
10000000011111000001
1P0000110E0000000001
11111111111111111111
cccccccccccccccccccc