11111111111111
1X00000E000001
10001100111001
10010100101001
1P100100001001
1011111C010001
10000100100001
10000100111001
1000000C000001
11111111111111