11111111111111111111
1000X00000E000000001
10000001100111000001
10000010100101000001
1000P100100001000001
1000011111C010000001
10000000100100000001
10000000100111000001
1000000000C000000001
11111111111111111111