1111111111111111
1001000000000001
1000011111111001
100011X000000001
1110111111111111
1110111111111111
10010000000000C1
1000011111111001
1P0011E000000001
1111111111111111