1111111111111111111111
10P10000X00011000000E1
1011011000000000000001
1000000000001100CC0001
100C000001111100000001
110000C000000CC0000001
1100010011111111111001
10000100000CC0000C0001
1100010000000CCC000011
10000001110000CCC00111
1111111111111111111111