111111111
1EXC00001
1C0000001
100000001
1P0000001
111111111