1111111111111111
1001000000000001
1000011111111001
100011X000000001
1000111111111001
1010111111111101
10010000000000C1
1000011111111001
1P0011E000000001
1111111111111111