1111111111111111111111
10P10000X00011000000E1
1011011000000000000001
1000000000001100000001
100C000001111100000001
110000C000000000000001
1100010011111111111001
1000010000000000000001
1100010000000000000011
1000000111000000000111
1111111111111111111111