1111111111111111111111
10P10000000011000000E1
1011011000000000000001
1000000000001100000001
100C0000011111000M0001
110000C000000000000001
1100010011111111111001
1000010000000000000001
11000100000000000M0011
10M0000111000000000111
1111111111111111111111