1111111111111
1001000000001
1C00011111001
100011XX0C001
1110111111111
1110111111111
1E000000000C1
10X0011111001
1P0011C000001
1111111111111
