1111111111111
1001000000001
1000011111001
100011XX00001
1110111111111
1110111111111
10010000000C1
10X0011111001
1P0011E000001
1111111111111
