1111111111111111
1C01000000000001
1000011111111001
100010X00000C001
1000101111111001
1010101111111101
10010000000000C1
1000011111111001
1P0011E000000001
1111111111111111