11111111111111111
10011111000000001
1C000111110001001
1000000011100C001
11100000110100011
11100000110101111
1E001100000000XC1
10001001010111001
1P00000011C000001
11111111111111111