1111111111111111111111
10P10000X00C11000000E1
1011011000000000000001
10000000C0011000CC0001
100C000001111100000001
110000C000000CC0000001
1100010011111111111001
10000100000C00000C0001
110001000000000C000011
1000000111000000C00111
1111111111111111111111