111111111111111111111111111111111
10000C000000C000000C0000111111111
100C000000P0001111111100000000001
100000001111111110000000001111E11
111000000000000000011111000001101
10000C00000C1111C00000C0000010C01
101C0000111000C0001110000C0000011
10C000C0000C00X011C0100C00C000111
1000C0000C000C0000000100011110011
1000C0000C0001C00C00C00000C000011
111111111111111111111111111111111
