111111111111111111111111111111111
10000C000000C000000C0000111111111
100C00000000001111111100000000001
100000001111111110000000001111E11
1110000000000000000P0000000000001
100111111111111111111111111110C01
100C00000000000000000C00000000011
100000C0000C00X011C0100C00C000111
1000C0000C000C0000000100011110011
1000C0000C0001C00C00C00000C000011
111111111111111111111111111111111
