111111111111111111111111
1000000000011110001000E1
1101010010C1000001001001
100100100100101010X00001
1011101101100010110C10C1
101000001011C10001100111
101C10C10110001100000101
100111000010011000010011
11001101011C110010110101
10C0001C00010C0C10010111
111P1101101C011111C00011
111111111111111111111111
