1111111111111111111111111
100000000000C0000000P00X1
1001111111111110000100111
101000000000C000000000001
1010011111111100110001101
101010000000C000000000101
1010100111111000100010101
101010100000C000000010101
1010101001110000001010101
101010101000C000001C1C1C1
1010101010011000101010101
10101010101C000C101010101
101010101011E010101010101
1010101010100C10101010101
1010101010011100101010101
101010101000000C101010101
1C1C1C1C01111111101010101
10101010000C0000001010101
1010100111111111110010101
10101000000C0000000010101
1010011111111111111110101
10100000000C0000000000101
1001111111111111111111001
10000000000C0000000000001
1111111111111111111111111