1111111111111111
1001000000000001
1000000111111001
100000X000000001
1000111111111001
1000111111111101
1000000000000001
1000011111111001
1P000CE000000001
1111111111111111