11111111111111111111
1C0000001000000CC0C1
1001000001110000C001
10000000000000000001
1P0000110E0000000001
11111111111111111111