11111111111111111111
100000001000000CC0C1
1001000001110000C001
10000000000000000001
1PC000110E0000000001
11111111111111111111