11111111111111111111
1X0000001000000CC0C1
1001000E01110000C001
10000000000000000001
1PC00011000000000001
11111111111111111111