11111111111111111111111111
10000000000000000000C00001
10000010000000000000000001
1000001C000000000011111001
10E00011100000000010001001
10000010000000000010P01001
10000000000C00000011111001
10C00000000000000000000001
1000000000000000C000000001
11111111111111111111111111
