111111111
100C00001
100101111
110C01C11
10C001111
10P0000E1
111111111
