111111111111111111111111111
1000E0000000110000000000001
100000000110100000101100001
100000010000000000000000001
100111000000001000E00000001
100001111000000000000111111
1000000001100000000001000P1
100000000000100000000001111
111111111111111111111111111