111111111111100111111111111
100000000000000000000000001
100000000000000000000000001
100000010000000000000000000
100000000000001000000000001
1000000000C0000000000111111
1000000001000000000001000E1
100P00000000100000000001111
111111111101111111111111111