111111111111111111111111111
100000000000000000000000001
1000000C0000000000000000001
10000001000000000S000000001
100000000000001000000000001
100000000000000000000111111
1000000001000000000001000E1
100P00000000100000000001111
111111111111111111111111111