111111111
100001
1000C1
100001
1P0001
111111