1111111111111111
1P00000000000001
1000000000000001
111111111E111111
1000000000C00001
1111111111111111