111111111
100C000X1
100101111
110C1EC11
111101111
10P000101
111111111