111111111
100C000X1
100101111
110C00C11
11111E111
10P000C01
111111111