11111
101E1
10011
1P0C1
11111
