11111111111111111111111111
10000000000000000000C00001
10000010000000000000000001
10111101C00000000011111001
111111111111111E1111111111
10100100000C00000011111001
10011010000000000000C01001
10000000000C00000011111001
10P00000000000000000000001
1000000000000000C000000001
11111111111111111111111111
