111111
1000E1
1000C1
100001
1P0001
111111