111111
1PPE11
1P1111
1P0001
1P0C01
111111
111111